EEWE2EE1EEEE1ETE
2EW4EEE31EE2EE12
TE1EEWEE3EE1EEE3
EEEEE21EEETE13EE
2EE3EEEEEEEE3EE2
EE31ETEWE12EEEEE
3EEE1EE3EWEEE1ET
21EE2EE13EEE4EE2
ETE1EEWE1EE2EEEE
