EEE1T1EEEEEEEEE1T1EE
EEE111EEEEEEEEE111EE
EEEEEEEEEEEEEEEEEEEE
EEEEEEEEEEEEEEEEEEEE
EEEEEEEEEEEEEEEEEEEE
11EEEEEEEEEEEEEEEEEE
T1EEEEWWWWWEEEEEEE11
11EEEEWT44WEEEEEEE1E
EEEEEEWWWWWEEEEEE11E
EEEEEEEEEEEEEEEEEEEE
EEEEEEEEEEEEEEEEEEEE
11EEEEEEEEEEEEEEEEEE
T1EEEEEEEEEEEEEEEE11
11EEEEEEEEEEEEEEEE1T
EEEEEEEEEEEEEEEEEE11
EEEEEEEEEEEEEEEEEEEE
EEEEEEEEEEEEEEEEEEEE
EEEEEEEEEEEEEEEEEEEE
EE111EEEEEEEEE111EEE
EE1T1EEEEEEEEE1T1EEE
