EEWEWE1EEE1EEE1EEEEE
ETWEEEEE2EWEEEEE2EE1
WWW2EEEEEE2E1EEE3TEE
EEEEEEEEEEE11EEEEEEE
EEEEEEE432T2EEWWWEEE
EEEEEEEE2T234EEEEEEE
EEEEWEEWEEWEEEEEEEEE
EET3EEE1E2EEEEEE2WWW
1EE2WWWWEEE2EEEEEWTE
EEEEW1EEE1EEE1EEEWEE
