ETWEEEEEEEEEEEEEWWE
WWWEEEEEEEEEEEEEWT1
EEEEEEEEEEEEEEEEWWW
EEEWWWWWEEEWWWWWEEE
EEEW112WEEEW112WEEE
EEEW2T2WEEEW2T2WEEE
EEEW211WEEEW211WEEE
EEEWWWWWEEEWWWWWEEE
WWWEEEEEEEEEEEEEEEE
1TWEEEEWWEEEEEEEWWW
EWWEEEEEEEEEEEEEWTE
